Personbeskrivning: Kapten Bill, en låg-nivå enkel fysisk arbetare, som ofta slåss med andra, och arbetar på skepp, har lite pengar, arbetar som styrman eller kapten, tyrannisk(despotisk) och svår-gående

Den blinde

Viktiga saker i boken:
...

När Jim hade skattkartan lämnade han till den gode trovärdige doktorn Livesey, för man blir avrättad lämnade till onde och dessutom har han ingen kapacitet att kunna hitta skatten själv.

Frågor:
P7: Vad ska förtigas? Varför?

Fraser (komma ihåg):
Jag var hungrig som en varg = (Jag är jättehungrig)
Jag har sett med egna ögon = (Jag har själv sett)
Saken är klar som dagen = (Väldigt klar)
Blodtörstig

Fraserna (bygg mening):
Angelägen: Alla elever var inte angelägna om att gå tillbaka till skolan.
Rusa upp: rycka till vid känslor
Visseligen men: (Rätt): Han är visseligen liten, men han är väldigt stark. (Fel): Jag har visseligen tagit med mig allt, men jag upptäcker att något fattas.
Vad beträffar: Vad min kompis beträffar, så har han inte varit i skolan på senaste tiden.
Vad det beträffar om att: ...

Okända ord:
I land / På landet / Åka till landet / Till sjöss
Palissad: Befästningsverk av pålar
Hala: dra (Hala ner flaggan)
En heder: Ära (Hedersord, lova på hedersord)
Hövding: Ledare för en folkstam eller folkgrupp
Förtiga: Tiga med
Nådens år: Kalenderår, herrens år
Linka: Halta, stappla
Tjära: Ett mörkt, tjockflytande ämne som skyddar mot röta (Asfalt)
Tjärig: Svart, brun, smutsig, asfaltig
Hårpiska: Fläta
Stämma upp: Plötsligt börjar tala
Gast: Spöke
Gastkrama: Hålla i stark spänning (En gastkramande thriller)
Ankarspel: Mekanisk anordning med viken ett ankare fälls eller lyfts
Bulta: Banka, slå
Brysk: Ovänlig, hänsynslös
Bister: hård
Kännare: expert
Matros: Sjöman som arbetar på däck
4.10 (Postdiligens) ska skrivas, inte skriven ännu

ragla: (ragla i säng)

Spiselkrans: Dekorativ ram runt öppen spis
Snagga: Klippa mycket kort
Vedervärdig: Vidrig
Förtjänst: God egenskap
Det kliar i fingrarna på honom att: har en lust att genast göra
Förtjänt: Värd
Försegla: Tillsluta med sigill (Seal)
Kråkfötter: Klotter
Införa: Börja använda
Förväxling: Sammanblandning
Kapa: Erövra fordon under vapenhot (Hijack)
Berest: Han som har rest mest
Lodning: mätning av vattendjup
Sund: smalt vattenomrde mellam 2 vattenområde
Inlopp: infartsled till hamn
Mässpojke: pojke som är servitör i fartygmatsal
Skonert: loggert